########################################
#                                      #
### ####################################
#                                      #
##### ###########################   ####
##### ###                           ####
##### ###                           ####
##### ### ############## ######### #####
###       ###             ######## #####
###  #### ############### ########   ###
###  #### ### ###       #B########## ###
###  ###   ##     ##### #########    ###
### ####   ###### ####         ###   ###
##  ####   ###### ############  ########
## ####           ##        ### ########
######  ##### ###### ###### ###      ###
###    ###### #      ###### ### ###  ###
### ######### # ###########     ###  ###
### ##        # ###    ############  ###
#####  ### #### ### ## ###        #  ###
##### #### ####     #  ##### ####    ###
#A ## #### ########## ###    ##   ## ###
##    ####            ############## ###
########################################
