#        #
#   #### #
#   #B # #
#   ## # #
#        #
#A########

