#        #
# ###### #
# ###B # #
# #### # #
#        #
#A########

