####################
## #####    ###   B#
## ##    ####   ####
## ## ## #### ######
## ## ##      ######
##    ## ######## ##
### #### ######## ##
### #### #####    ##
#A  ####       #####
####################
