##########
####### B#
####    ##
#### #####
#    #####
# ########
#A########
##########
